/	home.views.redirect_no_url		login_required
/admin/	account.decorators.wrapper_func	admin-home
/admin/account/	account.views.EmployeesListView	account:employees-list
/admin/account/<int:pk>/	account.decorators.wrapper_func	account:employees-detail
/admin/account/<int:pk>/confirm-password-reset/	account.decorators.wrapper_func	account:employees-confirm-password-reset
/admin/account/<int:pk>/delete/	account.decorators.wrapper_func	account:employees-delete
/admin/account/<int:pk>/disable/	account.decorators.wrapper_func	account:disable-account
/admin/account/<int:pk>/edit/	account.decorators.wrapper_func	account:account-edit
/admin/account/<int:pk>/enable/	account.decorators.wrapper_func	account:enable-account
/admin/account/<int:pk>/post/password-reset/	account.decorators.wrapper_func	account:post-password-reset
/admin/account/add/	account.decorators.wrapper_func	account:employees-add
/admin/account/edit/	django.contrib.auth.views.PasswordChangeView	account:edit
/admin/change-password/	django.contrib.auth.views.PasswordChangeView	password_change
/admin/clients/	clients.views.ClientListView	clients:list
/admin/clients/<int:client_pk>/discount/<int:discount_pk>/delete	account.decorators.wrapper_func	clients:delete-discount
/admin/clients/<int:client_pk>/discount/<int:discount_pk>/edit	account.decorators.wrapper_func	clients:edit-discount
/admin/clients/<int:pk>/	account.decorators.wrapper_func	clients:detail
/admin/clients/<int:pk>/add-discount/	account.decorators.wrapper_func	clients:add-discount
/admin/clients/<int:pk>/delete/	account.decorators.wrapper_func	clients:delete
/admin/clients/<int:pk>/edit/	account.decorators.wrapper_func	clients:edit
/admin/clients/add/	account.decorators.wrapper_func	clients:add
/admin/deposits/	deposit.views.DepositListView	deposits:list
/admin/deposits/<int:pk>/	account.decorators.wrapper_func	deposits:detail
/admin/deposits/<int:pk>/delete/	account.decorators.wrapper_func	deposits:delete
/admin/deposits/<int:pk>/edit/	account.decorators.wrapper_func	deposits:edit
/admin/deposits/add/	account.decorators.wrapper_func	deposits:add
/admin/envios/	envios.views.EnvioListView	envios:envio-list
/admin/envios/<int:pk>/	envios.views.EnvioDetailView	envios:envio-detail
/admin/envios/<int:pk>/delete/	account.decorators.wrapper_func	envios:envio-delete
/admin/envios/<int:pk>/edit/	account.decorators.wrapper_func	envios:envio-edit
/admin/envios/add/	envios.views.EnvioCreate	envios:envio-add
/admin/envios/bulk-add/	account.decorators.wrapper_func	envios:envio-bulk-add
/admin/envios/bulk-add/<int:pk>/fix/	account.decorators.wrapper_func	envios:bulk-handle
/admin/envios/bulk-add/<int:pk>/success/	account.decorators.wrapper_func	envios:envio-bulk-add-success
/admin/envios/bulk-add/download-excel-to-fix/<int:pk>/	envios.views.print_excel_file	envios:bulk-download-fix-excel
/admin/envios/download/	account.decorators.wrapper_func	envios:envio-download-labels
/admin/envios/download/<int:pk>/	account.decorators.wrapper_func	envios:single-envio-download-label
/admin/envios/post_ids/	account.decorators.wrapper_func	envios:post-selected-ids
/admin/home	account.decorators.wrapper_func	admin-home
/admin/logout/	account.views.logout_view	logout
/admin/places/partido	account.decorators.wrapper_func	places:partido-list
/admin/places/partido/<int:pk>	places.views.PartidoDetailView	places:partido-detail
/admin/places/partido/<int:pk>/edit	account.decorators.wrapper_func	places:partido-edit
/admin/places/partido/<partidosids>/bulk_edit	account.decorators.wrapper_func	places:partido-bulk-edit
/admin/places/town	places.views.TownListView	places:town-list
/admin/places/town/<int:pk>	account.decorators.wrapper_func	places:town-detail
/admin/places/town/<int:pk>/edit	places.views.TownUpdateView	places:town-edit
/admin/places/town/<townsids>/bulk_delivery_edit	account.decorators.wrapper_func	places:town-delivery-bulk-edit
/admin/places/town/<townsids>/bulk_flex_edit	account.decorators.wrapper_func	places:town-flex-bulk-edit
/admin/places/zone/	account.decorators.wrapper_func	places:zone-list
/admin/places/zone/<int:pk>	places.views.ZoneDetailView	places:zone-detail
/admin/places/zone/<int:pk>/edit/	account.decorators.wrapper_func	places:zone-edit
/admin/places/zone/<zoneids>/delete	account.decorators.wrapper_func	places:zone-delete
/admin/places/zone/add	account.decorators.wrapper_func	places:zone-add
/admin/prices/delivery/	account.decorators.wrapper_func	prices:dcode-list
/admin/prices/delivery/<int:pk>/	prices.views.DeliveryCodeDetailView	prices:dcode-detail
/admin/prices/delivery/<int:pk>/edit/	prices.views.DeliveryCodeUpdateView	prices:dcode-edit
/admin/prices/delivery/add/	prices.views.DeliveryCodeAddView	prices:dcode-add
/admin/prices/delivery/bulk-update/fixed/<str:dcodeids>/	account.decorators.wrapper_func	prices:dcode-fixed-bulk-edit
/admin/prices/delivery/bulk-update/percentage/<str:dcodeids>/	account.decorators.wrapper_func	prices:dcode-percentage-bulk-edit
/admin/prices/delivery/delete/<dcodeids>/	account.decorators.wrapper_func	prices:dcode-delete
/admin/prices/flex/	account.decorators.wrapper_func	prices:fcode-list
/admin/prices/flex/<int:pk>	prices.views.FlexCodeDetailView	prices:fcode-detail
/admin/prices/flex/<int:pk>/edit/	prices.views.FlexCodeUpdateView	prices:fcode-edit
/admin/prices/flex/add/	prices.views.FlexCodeAddView	prices:fcode-add
/admin/prices/flex/bulk-update/fixed/<str:fcodeids>/	account.decorators.wrapper_func	prices:fcode-fixed-bulk-edit
/admin/prices/flex/bulk-update/percentage/<str:fcodeids>/	account.decorators.wrapper_func	prices:fcode-percentage-bulk-edit
/admin/prices/flex/delete/<fcodeids>/	account.decorators.wrapper_func	prices:fcode-delete
/admin/summaries/clients/	summaries.views.ClientSummaryListView	summaries:client-list
/admin/summaries/clients/<int:pk>/	account.decorators.wrapper_func	summaries:client-detail
/admin/summaries/clients/<int:pk>/print-csv/	account.decorators.wrapper_func	summaries:client-print-csv
/admin/summaries/clients/<int:pk>/print-pdf/	account.decorators.wrapper_func	summaries:client-print-pdf
/admin/summaries/clients/<int:pk>/print-xls/	account.decorators.wrapper_func	summaries:client-print-excel
/admin/summaries/clients/<int:pk>/total-cost/	account.decorators.wrapper_func	summaries:client-summary-total-cost
/admin/summaries/clients/add/	account.decorators.wrapper_func	summaries:client-add
/admin/summaries/employees/	summaries.views.EmployeeSummaryListView	summaries:employee-list
/admin/summaries/employees/<int:pk>/	account.decorators.wrapper_func	summaries:employee-detail
/admin/summaries/employees/<int:pk>/print-csv/	account.decorators.wrapper_func	summaries:employee-print-csv
/admin/summaries/employees/<int:pk>/print-pdf/	account.decorators.wrapper_func	summaries:employee-print-pdf
/admin/summaries/employees/<int:pk>/print-xls/	account.decorators.wrapper_func	summaries:employee-print-excel
/admin/summaries/employees/<int:pk>/total-cost/	account.decorators.wrapper_func	summaries:employee-summary-total-cost
/admin/summaries/employees/add/	account.decorators.wrapper_func	summaries:employee-add
/admin/tickets/	account.decorators.wrapper_func	tickets:list
/admin/tickets/<int:pk>/	account.decorators.wrapper_func	tickets:detail
/admin/tickets/<int:pk>/delete/	account.decorators.wrapper_func	tickets:delete
/admin/tickets/add/	tickets.views.CreateTicketView	tickets:add
/admin/transactions/	account.decorators.wrapper_func	transactions:list
/admin/transactions/<int:pk>/delete/	account.decorators.wrapper_func	transactions:delete
/admin/transactions/<int:pk>/edit/	account.decorators.wrapper_func	transactions:edit
/admin/transactions/add/	account.decorators.wrapper_func	transactions:add
/api/account/carrier/<int:pk>/	account.api.views.api_detail_carrier_view	account-api:carrier-detail
/api/account/carriers/	account.api.views.ApiCarrierListView	account-api:carriers
/api/account/employee/<int:pk>/	account.api.views.api_detail_account_view	account-api:employee-detail
/api/account/employee/<int:pk>/check-app-state/	account.api.views.api_check_app_state_view	account-api:employee-check-app-state
/api/account/employees-with-envios/	account.api.views.ApiEmployeesWithEnviosListView	account-api:employees-with-envios
/api/account/login/	account.api.views.ObtainAuthTokenView	account-api:login
/api/account/properties/	account.api.views.api_account_properties_view	account-api:properties
/api/account/reset-password/	account.api.views.api_reset_password	account-api:reset-password
/api/clients/clients-at-deposit/<int:deposit_id>/	clients.api.views.ApiClientsAtDepositListView	clients_api:towns-at-deposit
/api/deposit/	deposit.api.views.ApiDepositListView	deposit_api:list
/api/deposit/<int:pk>/	deposit.api.views.api_detail_deposit_view	deposit_api:detail
/api/deposit/for-envios-with-carrier/<int:carrier_pk>/	deposit.api.views.ApiDepositForEnviosWithCarrierListView	deposit_api:detail
/api/deposit/own/	deposit.api.views.ApiOwnDepositsListView	deposit_api:own
/api/deposit/with-envios-list/	deposit.api.views.ApiDepositWithEnviosListView	deposit_api:with-envios-list
/api/envios/list/	envios.api.views.ApiEnvioListView	envios_api:list
/api/envios/list/carrier/<int:carrier_pk>/	envios.api.views.ApiEnvioListOfCarrierView	envios_api:envios-of-carrier
/api/places/partidos-at-carrier-with-deposit/<int:carrier_id>/	places.api.views.ApiPartidosAtCarrierWithClientFromDepositListView	places_api:partidos-at-carrier
/api/places/partidos-at-carrier/<int:carrier_id>/	places.api.views.ApiPartidosAtCarrierListView	places_api:partidos-at-carrier
/api/places/partidos-at-deposit/<int:deposit_id>/	places.api.views.ApiPartidosAtDepositListView	places_api:partidos-at-deposit
/api/places/towns-at-carrier-with-deposit/<int:carrier_id>/	places.api.views.ApiTownsAtCarrierWithClientFromDepositListView	places_api:towns-at-carrier
/api/places/towns-at-carrier/<int:carrier_id>/	places.api.views.ApiTownsAtCarrierListView	places_api:towns-at-carrier
/api/places/towns-at-deposit/<int:deposit_id>/	places.api.views.ApiTownsAtDepositListView	places_api:towns-at-deposit
/api/places/zones-at-carrier/<int:carrier_id>/	places.api.views.ApiZonesAtCarrierListView	places_api:zones-at-carrier
/api/places/zones-at-deposit/<int:deposit_id>/	places.api.views.ApiZonesAtDepositListView	places_api:zones-at-deposit
/api/tracking/deliver/attempt/	tracking.api.deliver.views.api_delivery_attempt_view	tracking_api:api-delivery-attempt
/api/tracking/deliver/success/	tracking.api.deliver.views.api_post_successfull_delivery_view	tracking_api:api-post-successfull-delivery
/api/tracking/deposit/all/	tracking.api.deposit.views.api_deposit_all_view	tracking_api:api-deposit-all
/api/tracking/deposit/by-envios-ids/	tracking.api.deposit.views.api_deposit_by_envios_ids_view	tracking_api:api-deposit-ids
/api/tracking/deposit/by-partidos-ids/	tracking.api.deposit.views.api_deposit_by_partidos_ids_view	tracking_api:api-deposit-by-partido
/api/tracking/deposit/by-towns-ids/	tracking.api.deposit.views.api_deposit_by_towns_ids_view	tracking_api:api-deposit-by-town
/api/tracking/deposit/by-zones-ids/	tracking.api.deposit.views.api_deposit_by_zones_ids_view	tracking_api:api-deposit-by-zone
/api/tracking/deposit/preview/	tracking.api.deposit.views.api_envios_for_deposit_preview	tracking_api:api-deposit-preview
/api/tracking/devolver/all/	tracking.api.devolver.views.api_devolver_all_view	tracking_api:api-devolver-all
/api/tracking/devolver/by-envios-ids/	tracking.api.devolver.views.api_devolver_by_envios_ids_view	tracking_api:api-devolver-ids
/api/tracking/devolver/by-partidos-ids/	tracking.api.devolver.views.api_devolver_by_partidos_ids_view	tracking_api:api-devolver-by-partido
/api/tracking/devolver/by-towns-ids/	tracking.api.devolver.views.api_devolver_by_towns_ids_view	tracking_api:api-devolver-by-town
/api/tracking/devolver/preview/	tracking.api.devolver.views.api_envios_for_devolver_preview	tracking_api:api-devolver-preview
/api/tracking/summary/<int:carrier_pk>/	tracking.api.summary.views.TrackingMovementsForCarrierListView	tracking_api:tracking-summary-list
/api/tracking/transfer/all/	tracking.api.transfer.views.api_transfer_all_view	tracking_api:api-transfer-all
/api/tracking/transfer/by-envios-ids/	tracking.api.transfer.views.api_transfer_by_envios_ids_view	tracking_api:api-transfer-ids
/api/tracking/transfer/by-partidos-ids/	tracking.api.transfer.views.api_transfer_by_partidos_ids_view	tracking_api:api-transfer-by-partido
/api/tracking/transfer/by-towns-ids/	tracking.api.transfer.views.api_transfer_by_towns_ids_view	tracking_api:api-transfer-by-town
/api/tracking/transfer/by-zones-ids/	tracking.api.transfer.views.api_transfer_by_zones_ids_view	tracking_api:api-transfer-by-zone
/api/tracking/transfer/preview/	tracking.api.transfer.views.api_envios_for_transfer_preview	tracking_api:api-transfer-preview
/api/tracking/withdraw/all/	tracking.api.withdraw.views.api_withdraw_all_view	tracking_api:api-withdraw-all
/api/tracking/withdraw/by-clients-ids/	tracking.api.withdraw.views.api_withdraw_by_clients_ids_view	tracking_api:api-withdraw-by-clients
/api/tracking/withdraw/by-partidos-ids/	tracking.api.withdraw.views.api_withdraw_by_partidos_ids_view	tracking_api:api-withdraw-by-partido
/api/tracking/withdraw/by-towns-ids/	tracking.api.withdraw.views.api_withdraw_by_towns_ids_view	tracking_api:api-withdraw-by-town
/api/tracking/withdraw/by-tracking-envios-ids/	tracking.api.withdraw.views.api_withdraw_by_envios_ids_view	tracking_api:api-withdraw-ids
/api/tracking/withdraw/by-zones-ids/	tracking.api.withdraw.views.api_withdraw_by_zones_ids_view	tracking_api:api-withdraw-by-zone
/api/tracking/withdraw/preview/	tracking.api.withdraw.views.api_envios_for_withdraw_preview	tracking_api:api-withdraw-preview
/clients/	clients_only.views.index	clients_only:index
/clients/<int:pk>/	clients_only.views.detail_envio_view	clients_only:envio-detail
/clients/<int:pk>/delete/	clients_only.views.update_envio_view	clients_only:envio-delete
/clients/<int:pk>/edit/	clients_only.views.cancel_envio_view	clients_only:envio-edit
/clients/add/	clients_only.views.create_envio_view	clients_only:envio-add
/delete-alert-from-session/<str:id>	home.views.delete_alert_from_session	delete-alert
/login/	account.views.login_view	login
/media/<path>	django.views.static.serve
/mobile/	account.decorators.wrapper_func	mobile:index
/mobile/account/	account.decorators.wrapper_func	mobile:account
/mobile/deliver/	account.decorators.wrapper_func	mobile-deliver:scan
/mobile/deliver/result	account.decorators.wrapper_func	mobile-deliver:select-result
/mobile/deliver/result/confirm	account.decorators.wrapper_func	mobile-deliver:confirm-result
/mobile/deliver/result/confirm/other	account.decorators.wrapper_func	mobile-deliver:confirm-other
/mobile/deposit/	account.decorators.wrapper_func	mobile-deposit:index
/mobile/deposit/<int:carrier_pk>	account.decorators.wrapper_func	mobile-deposit:select-deposit
/mobile/deposit/<int:carrier_pk>/at/<int:deposit_pk>	account.decorators.wrapper_func	mobile-deposit:carrier
/mobile/deposit/<int:carrier_pk>/at/<int:deposit_pk>/confirm-all	account.decorators.wrapper_func	mobile-deposit:confirm-all
/mobile/deposit/<int:carrier_pk>/at/<int:deposit_pk>/filter	account.decorators.wrapper_func	mobile-deposit:filter-by
/mobile/deposit/<int:carrier_pk>/at/<int:deposit_pk>/filter/confirm	account.decorators.wrapper_func	mobile-deposit:confirm-filtered
/mobile/deposit/<int:carrier_pk>/at/<int:deposit_pk>/scan	account.decorators.wrapper_func	mobile-deposit:scan
/mobile/deposit/<int:carrier_pk>/at/<int:deposit_pk>/scan/confirm	account.decorators.wrapper_func	mobile-deposit:confirm-scanned
/mobile/transfer/	account.decorators.wrapper_func	mobile-transfer:index
/mobile/transfer/<int:carrier_pk>	account.decorators.wrapper_func	mobile-transfer:select-receiver
/mobile/transfer/<int:carrier_pk>/to/<int:receiver_pk>	account.decorators.wrapper_func	mobile-transfer:carrier
/mobile/transfer/<int:carrier_pk>/to/<int:receiver_pk>/confirm-all	account.decorators.wrapper_func	mobile-transfer:confirm-all
/mobile/transfer/<int:carrier_pk>/to/<int:receiver_pk>/filter	account.decorators.wrapper_func	mobile-transfer:filter-by
/mobile/transfer/<int:carrier_pk>/to/<int:receiver_pk>/filter/confirm	account.decorators.wrapper_func	mobile-transfer:confirm-filtered
/mobile/transfer/<int:carrier_pk>/to/<int:receiver_pk>/scan	account.decorators.wrapper_func	mobile-transfer:scan
/mobile/transfer/<int:carrier_pk>/to/<int:receiver_pk>/scan/confirm	account.decorators.wrapper_func	mobile-transfer:confirm-scanned
/mobile/withdraw/	account.decorators.wrapper_func	mobile-withdraw:index
/mobile/withdraw/<int:deposit_pk>	account.decorators.wrapper_func	mobile-withdraw:select-carrier
/mobile/withdraw/<int:deposit_pk>/to/<int:carrier_pk>	account.decorators.wrapper_func	mobile-withdraw:deposit
/mobile/withdraw/<int:deposit_pk>/to/<int:carrier_pk>/confirm-all	account.decorators.wrapper_func	mobile-withdraw:confirm-all
/mobile/withdraw/<int:deposit_pk>/to/<int:carrier_pk>/filter	account.decorators.wrapper_func	mobile-withdraw:filter-by
/mobile/withdraw/<int:deposit_pk>/to/<int:carrier_pk>/filter/confirm	account.decorators.wrapper_func	mobile-withdraw:confirm-filtered
/mobile/withdraw/<int:deposit_pk>/to/<int:carrier_pk>/scan	account.decorators.wrapper_func	mobile-withdraw:scan
/mobile/withdraw/<int:deposit_pk>/to/<int:carrier_pk>/scan/confirm	account.decorators.wrapper_func	mobile-withdraw:confirm-scanned
/password-change-done/	account.views.login_view	password_change_done
/reset-password/	account.decorators.wrapper_func	reset-password
/static/<path>	django.views.static.serve
/superadmin/	django.contrib.admin.sites.index	admin:index
/superadmin/<app_label>/	django.contrib.admin.sites.app_index	admin:app_list
/superadmin/account/account/	django.contrib.admin.options.changelist_view	admin:account_account_changelist
/superadmin/account/account/<id>/password/	django.contrib.auth.admin.user_change_password	admin:auth_user_password_change
/superadmin/account/account/<path:object_id>/	django.views.generic.base.RedirectView
/superadmin/account/account/<path:object_id>/change/	django.contrib.admin.options.change_view	admin:account_account_change
/superadmin/account/account/<path:object_id>/delete/	django.contrib.admin.options.delete_view	admin:account_account_delete
/superadmin/account/account/<path:object_id>/history/	django.contrib.admin.options.history_view	admin:account_account_history
/superadmin/account/account/add/	django.contrib.auth.admin.add_view	admin:account_account_add
/superadmin/account/account/autocomplete/	django.contrib.admin.options.autocomplete_view	admin:account_account_autocomplete
/superadmin/auth/group/	django.contrib.admin.options.changelist_view	admin:auth_group_changelist
/superadmin/auth/group/<path:object_id>/	django.views.generic.base.RedirectView
/superadmin/auth/group/<path:object_id>/change/	django.contrib.admin.options.change_view	admin:auth_group_change
/superadmin/auth/group/<path:object_id>/delete/	django.contrib.admin.options.delete_view	admin:auth_group_delete
/superadmin/auth/group/<path:object_id>/history/	django.contrib.admin.options.history_view	admin:auth_group_history
/superadmin/auth/group/add/	django.contrib.admin.options.add_view	admin:auth_group_add
/superadmin/auth/group/autocomplete/	django.contrib.admin.options.autocomplete_view	admin:auth_group_autocomplete
/superadmin/authtoken/tokenproxy/	django.contrib.admin.options.changelist_view	admin:authtoken_tokenproxy_changelist
/superadmin/authtoken/tokenproxy/<path:object_id>/	django.views.generic.base.RedirectView
/superadmin/authtoken/tokenproxy/<path:object_id>/change/	django.contrib.admin.options.change_view	admin:authtoken_tokenproxy_change
/superadmin/authtoken/tokenproxy/<path:object_id>/delete/	django.contrib.admin.options.delete_view	admin:authtoken_tokenproxy_delete
/superadmin/authtoken/tokenproxy/<path:object_id>/history/	django.contrib.admin.options.history_view	admin:authtoken_tokenproxy_history
/superadmin/authtoken/tokenproxy/add/	django.contrib.admin.options.add_view	admin:authtoken_tokenproxy_add
/superadmin/authtoken/tokenproxy/autocomplete/	django.contrib.admin.options.autocomplete_view	admin:authtoken_tokenproxy_autocomplete
/superadmin/clients/client/	django.contrib.admin.options.changelist_view	admin:clients_client_changelist
/superadmin/clients/client/<path:object_id>/	django.views.generic.base.RedirectView
/superadmin/clients/client/<path:object_id>/change/	django.contrib.admin.options.change_view	admin:clients_client_change
/superadmin/clients/client/<path:object_id>/delete/	django.contrib.admin.options.delete_view	admin:clients_client_delete
/superadmin/clients/client/<path:object_id>/history/	django.contrib.admin.options.history_view	admin:clients_client_history
/superadmin/clients/client/add/	django.contrib.admin.options.add_view	admin:clients_client_add
/superadmin/clients/client/autocomplete/	django.contrib.admin.options.autocomplete_view	admin:clients_client_autocomplete
/superadmin/clients/discount/	django.contrib.admin.options.changelist_view	admin:clients_discount_changelist
/superadmin/clients/discount/<path:object_id>/	django.views.generic.base.RedirectView
/superadmin/clients/discount/<path:object_id>/change/	django.contrib.admin.options.change_view	admin:clients_discount_change
/superadmin/clients/discount/<path:object_id>/delete/	django.contrib.admin.options.delete_view	admin:clients_discount_delete
/superadmin/clients/discount/<path:object_id>/history/	django.contrib.admin.options.history_view	admin:clients_discount_history
/superadmin/clients/discount/add/	django.contrib.admin.options.add_view	admin:clients_discount_add
/superadmin/clients/discount/autocomplete/	django.contrib.admin.options.autocomplete_view	admin:clients_discount_autocomplete
/superadmin/deposit/deposit/	django.contrib.admin.options.changelist_view	admin:deposit_deposit_changelist
/superadmin/deposit/deposit/<path:object_id>/	django.views.generic.base.RedirectView
/superadmin/deposit/deposit/<path:object_id>/change/	django.contrib.admin.options.change_view	admin:deposit_deposit_change
/superadmin/deposit/deposit/<path:object_id>/delete/	django.contrib.admin.options.delete_view	admin:deposit_deposit_delete
/superadmin/deposit/deposit/<path:object_id>/history/	django.contrib.admin.options.history_view	admin:deposit_deposit_history
/superadmin/deposit/deposit/add/	django.contrib.admin.options.add_view	admin:deposit_deposit_add
/superadmin/deposit/deposit/autocomplete/	django.contrib.admin.options.autocomplete_view	admin:deposit_deposit_autocomplete
/superadmin/envios/bulkloadenvios/	django.contrib.admin.options.changelist_view	admin:envios_bulkloadenvios_changelist
/superadmin/envios/bulkloadenvios/<path:object_id>/	django.views.generic.base.RedirectView
/superadmin/envios/bulkloadenvios/<path:object_id>/change/	django.contrib.admin.options.change_view	admin:envios_bulkloadenvios_change
/superadmin/envios/bulkloadenvios/<path:object_id>/delete/	django.contrib.admin.options.delete_view	admin:envios_bulkloadenvios_delete
/superadmin/envios/bulkloadenvios/<path:object_id>/history/	django.contrib.admin.options.history_view	admin:envios_bulkloadenvios_history
/superadmin/envios/bulkloadenvios/add/	django.contrib.admin.options.add_view	admin:envios_bulkloadenvios_add
/superadmin/envios/bulkloadenvios/autocomplete/	django.contrib.admin.options.autocomplete_view	admin:envios_bulkloadenvios_autocomplete
/superadmin/envios/envio/	django.contrib.admin.options.changelist_view	admin:envios_envio_changelist
/superadmin/envios/envio/<path:object_id>/	django.views.generic.base.RedirectView
/superadmin/envios/envio/<path:object_id>/change/	django.contrib.admin.options.change_view	admin:envios_envio_change
/superadmin/envios/envio/<path:object_id>/delete/	django.contrib.admin.options.delete_view	admin:envios_envio_delete
/superadmin/envios/envio/<path:object_id>/history/	django.contrib.admin.options.history_view	admin:envios_envio_history
/superadmin/envios/envio/add/	django.contrib.admin.options.add_view	admin:envios_envio_add
/superadmin/envios/envio/autocomplete/	django.contrib.admin.options.autocomplete_view	admin:envios_envio_autocomplete
/superadmin/jsi18n/	django.contrib.admin.sites.i18n_javascript	admin:jsi18n
/superadmin/logger/log/	django.contrib.admin.options.changelist_view	admin:logger_log_changelist
/superadmin/logger/log/<path:object_id>/	django.views.generic.base.RedirectView
/superadmin/logger/log/<path:object_id>/change/	django.contrib.admin.options.change_view	admin:logger_log_change
/superadmin/logger/log/<path:object_id>/delete/	django.contrib.admin.options.delete_view	admin:logger_log_delete
/superadmin/logger/log/<path:object_id>/history/	django.contrib.admin.options.history_view	admin:logger_log_history
/superadmin/logger/log/add/	django.contrib.admin.options.add_view	admin:logger_log_add
/superadmin/logger/log/autocomplete/	django.contrib.admin.options.autocomplete_view	admin:logger_log_autocomplete
/superadmin/login/	django.contrib.admin.sites.login	admin:login
/superadmin/logout/	django.contrib.admin.sites.logout	admin:logout
/superadmin/password_change/	django.contrib.admin.sites.password_change	admin:password_change
/superadmin/password_change/done/	django.contrib.admin.sites.password_change_done	admin:password_change_done
/superadmin/places/partido/	django.contrib.admin.options.changelist_view	admin:places_partido_changelist
/superadmin/places/partido/<path:object_id>/	django.views.generic.base.RedirectView
/superadmin/places/partido/<path:object_id>/change/	django.contrib.admin.options.change_view	admin:places_partido_change
/superadmin/places/partido/<path:object_id>/delete/	django.contrib.admin.options.delete_view	admin:places_partido_delete
/superadmin/places/partido/<path:object_id>/history/	django.contrib.admin.options.history_view	admin:places_partido_history
/superadmin/places/partido/add/	django.contrib.admin.options.add_view	admin:places_partido_add
/superadmin/places/partido/autocomplete/	django.contrib.admin.options.autocomplete_view	admin:places_partido_autocomplete
/superadmin/places/town/	django.contrib.admin.options.changelist_view	admin:places_town_changelist
/superadmin/places/town/<path:object_id>/	django.views.generic.base.RedirectView
/superadmin/places/town/<path:object_id>/change/	django.contrib.admin.options.change_view	admin:places_town_change
/superadmin/places/town/<path:object_id>/delete/	django.contrib.admin.options.delete_view	admin:places_town_delete
/superadmin/places/town/<path:object_id>/history/	django.contrib.admin.options.history_view	admin:places_town_history
/superadmin/places/town/add/	django.contrib.admin.options.add_view	admin:places_town_add
/superadmin/places/town/autocomplete/	django.contrib.admin.options.autocomplete_view	admin:places_town_autocomplete
/superadmin/places/zipcode/	django.contrib.admin.options.changelist_view	admin:places_zipcode_changelist
/superadmin/places/zipcode/<path:object_id>/	django.views.generic.base.RedirectView
/superadmin/places/zipcode/<path:object_id>/change/	django.contrib.admin.options.change_view	admin:places_zipcode_change
/superadmin/places/zipcode/<path:object_id>/delete/	django.contrib.admin.options.delete_view	admin:places_zipcode_delete
/superadmin/places/zipcode/<path:object_id>/history/	django.contrib.admin.options.history_view	admin:places_zipcode_history
/superadmin/places/zipcode/add/	django.contrib.admin.options.add_view	admin:places_zipcode_add
/superadmin/places/zipcode/autocomplete/	django.contrib.admin.options.autocomplete_view	admin:places_zipcode_autocomplete
/superadmin/places/zone/	django.contrib.admin.options.changelist_view	admin:places_zone_changelist
/superadmin/places/zone/<path:object_id>/	django.views.generic.base.RedirectView
/superadmin/places/zone/<path:object_id>/change/	django.contrib.admin.options.change_view	admin:places_zone_change
/superadmin/places/zone/<path:object_id>/delete/	django.contrib.admin.options.delete_view	admin:places_zone_delete
/superadmin/places/zone/<path:object_id>/history/	django.contrib.admin.options.history_view	admin:places_zone_history
/superadmin/places/zone/add/	django.contrib.admin.options.add_view	admin:places_zone_add
/superadmin/places/zone/autocomplete/	django.contrib.admin.options.autocomplete_view	admin:places_zone_autocomplete
/superadmin/prices/deliverycode/	django.contrib.admin.options.changelist_view	admin:prices_deliverycode_changelist
/superadmin/prices/deliverycode/<path:object_id>/	django.views.generic.base.RedirectView
/superadmin/prices/deliverycode/<path:object_id>/change/	django.contrib.admin.options.change_view	admin:prices_deliverycode_change
/superadmin/prices/deliverycode/<path:object_id>/delete/	django.contrib.admin.options.delete_view	admin:prices_deliverycode_delete
/superadmin/prices/deliverycode/<path:object_id>/history/	django.contrib.admin.options.history_view	admin:prices_deliverycode_history
/superadmin/prices/deliverycode/add/	django.contrib.admin.options.add_view	admin:prices_deliverycode_add
/superadmin/prices/deliverycode/autocomplete/	django.contrib.admin.options.autocomplete_view	admin:prices_deliverycode_autocomplete
/superadmin/prices/flexcode/	django.contrib.admin.options.changelist_view	admin:prices_flexcode_changelist
/superadmin/prices/flexcode/<path:object_id>/	django.views.generic.base.RedirectView
/superadmin/prices/flexcode/<path:object_id>/change/	django.contrib.admin.options.change_view	admin:prices_flexcode_change
/superadmin/prices/flexcode/<path:object_id>/delete/	django.contrib.admin.options.delete_view	admin:prices_flexcode_delete
/superadmin/prices/flexcode/<path:object_id>/history/	django.contrib.admin.options.history_view	admin:prices_flexcode_history
/superadmin/prices/flexcode/add/	django.contrib.admin.options.add_view	admin:prices_flexcode_add
/superadmin/prices/flexcode/autocomplete/	django.contrib.admin.options.autocomplete_view	admin:prices_flexcode_autocomplete
/superadmin/r/<int:content_type_id>/<path:object_id>/	django.contrib.contenttypes.views.shortcut	admin:view_on_site
/superadmin/summaries/clientsummary/	django.contrib.admin.options.changelist_view	admin:summaries_clientsummary_changelist
/superadmin/summaries/clientsummary/<path:object_id>/	django.views.generic.base.RedirectView
/superadmin/summaries/clientsummary/<path:object_id>/change/	django.contrib.admin.options.change_view	admin:summaries_clientsummary_change
/superadmin/summaries/clientsummary/<path:object_id>/delete/	django.contrib.admin.options.delete_view	admin:summaries_clientsummary_delete
/superadmin/summaries/clientsummary/<path:object_id>/history/	django.contrib.admin.options.history_view	admin:summaries_clientsummary_history
/superadmin/summaries/clientsummary/add/	django.contrib.admin.options.add_view	admin:summaries_clientsummary_add
/superadmin/summaries/clientsummary/autocomplete/	django.contrib.admin.options.autocomplete_view	admin:summaries_clientsummary_autocomplete
/superadmin/summaries/employeesummary/	django.contrib.admin.options.changelist_view	admin:summaries_employeesummary_changelist
/superadmin/summaries/employeesummary/<path:object_id>/	django.views.generic.base.RedirectView
/superadmin/summaries/employeesummary/<path:object_id>/change/	django.contrib.admin.options.change_view	admin:summaries_employeesummary_change
/superadmin/summaries/employeesummary/<path:object_id>/delete/	django.contrib.admin.options.delete_view	admin:summaries_employeesummary_delete
/superadmin/summaries/employeesummary/<path:object_id>/history/	django.contrib.admin.options.history_view	admin:summaries_employeesummary_history
/superadmin/summaries/employeesummary/add/	django.contrib.admin.options.add_view	admin:summaries_employeesummary_add
/superadmin/summaries/employeesummary/autocomplete/	django.contrib.admin.options.autocomplete_view	admin:summaries_employeesummary_autocomplete
/superadmin/tickets/ticket/	django.contrib.admin.options.changelist_view	admin:tickets_ticket_changelist
/superadmin/tickets/ticket/<path:object_id>/	django.views.generic.base.RedirectView
/superadmin/tickets/ticket/<path:object_id>/change/	django.contrib.admin.options.change_view	admin:tickets_ticket_change
/superadmin/tickets/ticket/<path:object_id>/delete/	django.contrib.admin.options.delete_view	admin:tickets_ticket_delete
/superadmin/tickets/ticket/<path:object_id>/history/	django.contrib.admin.options.history_view	admin:tickets_ticket_history
/superadmin/tickets/ticket/add/	django.contrib.admin.options.add_view	admin:tickets_ticket_add
/superadmin/tickets/ticket/autocomplete/	django.contrib.admin.options.autocomplete_view	admin:tickets_ticket_autocomplete
/superadmin/tracking/trackingmovement/	django.contrib.admin.options.changelist_view	admin:tracking_trackingmovement_changelist
/superadmin/tracking/trackingmovement/<path:object_id>/	django.views.generic.base.RedirectView
/superadmin/tracking/trackingmovement/<path:object_id>/change/	django.contrib.admin.options.change_view	admin:tracking_trackingmovement_change
/superadmin/tracking/trackingmovement/<path:object_id>/delete/	django.contrib.admin.options.delete_view	admin:tracking_trackingmovement_delete
/superadmin/tracking/trackingmovement/<path:object_id>/history/	django.contrib.admin.options.history_view	admin:tracking_trackingmovement_history
/superadmin/tracking/trackingmovement/add/	django.contrib.admin.options.add_view	admin:tracking_trackingmovement_add
/superadmin/tracking/trackingmovement/autocomplete/	django.contrib.admin.options.autocomplete_view	admin:tracking_trackingmovement_autocomplete
/superadmin/transactions/transaction/	django.contrib.admin.options.changelist_view	admin:transactions_transaction_changelist
/superadmin/transactions/transaction/<path:object_id>/	django.views.generic.base.RedirectView
/superadmin/transactions/transaction/<path:object_id>/change/	django.contrib.admin.options.change_view	admin:transactions_transaction_change
/superadmin/transactions/transaction/<path:object_id>/delete/	django.contrib.admin.options.delete_view	admin:transactions_transaction_delete
/superadmin/transactions/transaction/<path:object_id>/history/	django.contrib.admin.options.history_view	admin:transactions_transaction_history
/superadmin/transactions/transaction/add/	django.contrib.admin.options.add_view	admin:transactions_transaction_add
/superadmin/transactions/transaction/autocomplete/	django.contrib.admin.options.autocomplete_view	admin:transactions_transaction_autocomplete
